30,30
......@........@...........@..
@..@..............@...........
...@.@..............@.........
..............................
..................@.....@..@..
.....@...........@..@@........
...@...@............@.........
.@...@...@@...................
........................@..@..
...............@.......@......
.............@..@.@@....@.....
.....@@.@...@.................
........@.@.........@...@...@.
.........@..@.@...............
@....................@.....@..
.@@......@........@...........
...@.......@....@.............
..........................@...
............@.........@......@
.....@........................
................@..........@..
....@.@.@..@.....@@...........
...@.....@....................
.@..........@...............@.
...............@..............
..@.............@......@......
.....................@........
.....@...@............@.......
............@.....@..@.....@..
.......@..@....@..@.@.....@...
