30,30
..........@............@......
.@..........@@........@.......
...@.....@...@................
.@@.........@..@..@........@..
...@...@...@................@@
........@..........@....@.@..@
..........@.....@..........@..
......@............@......@...
..............................
.....@.@...@...........@......
........@.............@.....@.
..............................
.........@..........@....@@@.@
....@......@..................
......@...@...................
..............@...............
...........................@@@
@..............@..............
....@......@.....@............
.@.......@........@...@......@
.......@.............@........
.........@..................@.
...@..........................
@........@..............@.....
@...@@..@........@............
.......@............@.........
..................@.@......@..
..@.......@.................@.
@....@..@.....................
.....@@..@.......@............
