30,30
...@................@.........
.....@........................
....@...@...@..............@..
...............@..............
....@.............@...........
.......@......@........@@..@..
@.@.........@..........@@.@...
.....................@.@@.....
.....................@........
....@..........@..............
..........@..................@
.........@..@..@.@..@..@......
.......................@.@@...
...........................@..
......@..@...@.@..............
@........@....................
......@......................@
@.....@............@.@........
.............@................
....@....@........@..........@
..........@....@@.....@.......
............@.................
....@.......................@.
..@................@..........
...@........@@...@...........@
@..........@...@..@.@....@.@..
..........@...@...............
.........@@....@..............
.............@@.@......@...@..
.........@....@...........@...
