30,30
......@...@@.....@.......@..@.
..@................@.....@..@.
........@..@.@..@.............
...........@..........@.......
..@...@....................@.@
.............................@
.......@.................@....
..............@..@......@.....
@..@.@....@...........@.......
............@...........@..@..
..............................
..@.....@.....................
....@...@.....................
........@...@.............@...
..................@@@.........
....@....................@@...
...................@..........
.@.......@.....@..............
...............@@...@.....@...
..@.@....................@.@..
.................@...@........
@..........@............@.....
@......@..@....@..............
....@.........@@...@@.......@.
........@.....................
.......@..@...................
@........................@....
.........@.......@.....@@.....
.@.....@..@........@.......@..
...@........................@.
