30,30
.@........@....@..@..@..@..@..
........................@.....
................@.....@.@...@.
..@................@.@.......@
........@...................@.
....@.................@.......
.................@......@..@@.
....@.........................
....@..@.@..@@........@....@@@
..............................
......@.................@.....
......@.................@.....
....@.....@.........@@.....@..
..@...@@......@............@.@
@.@....@....@.......@....@@...
....@.......@..........@.....@
......@......@................
...........@...@..@@..@.......
...........................@..
@.........@...................
..........................@...
............@....@....@.......
........................@.....
.@...@........@........@.....@
............................@.
..............................
@.............................
.........................@....
@..@.......@..................
...@.@....................@.@.
