30,30
.@......................@.....
...@...@@.....................
@.............@.......@......@
.....@...@........@....@......
........................@.....
......@....................@..
...........@@@.@..@....@..@..@
....................@.......@.
@.@........@.........@........
@..............@..............
........@.....@.........@@.@.@
....@.........................
@........@....................
........@....................@
....@....@......@.@.....@.....
..@.................@....@....
....@.......@..........@......
@.......@..........@..@.......
............@........@.....@.@
..............@...............
.......................@......
.......@.@.....@.....@........
..............................
.........@............@@......
........................@.....
...........@...@@@@...........
..@.........@..@...........@..
..@............@@.@...@...@...
...........................@..
..@...................@.......
